Electricity Infra - ABB, Simens, Schneider, Hitachi, BHEL
Cables - Dynamic cable
Transformers - Kecl, TRIL, 
Electrical Financing - PFC, IREDA, REC

Hevery enegineering - Elecon Engg
Heavy vehicle - ACE, BEML, Sanghvi movers, ESCORTS

Real estate - 
real estate material steel pipes - APL Apollo, Hariom Pipe, ISMT, Gandhi Special Tubes

Brokrage - IIFL sec, ICICI Securities, Nippon Life, LKP Securities, Adit.Birla Money, 5 paisa
Stocks - BSE, CDSL, 

Automobile -
Automobile equ - TRITON VALVES
Battery - Amara Raja, Exide
Carbon - Graphite india, 

Sesional Summer - Dodla, varun bev, Hatsun, Vadilal, venkys, SKM Egg
Sesional Winter - Monte carlo, Dabar,
Sesional Monson - 
Sessional IPL - zomato, PVR(negative),
Sessional Vacations ( december / March ) - 

Solar - websol, KP energy, BF utility, KPI, CESE, borosil renuebal, swelect
E vehicle - Olectra, Tata Motor, Ashok Leyland

PSUs - BEL, Containers, Shipping corp

Some metal stocks - Hind Zinc, Hind Copper 
Contract electronics - Dixon, Kayens
Mining - 

Railways - Skipper, Jupiter, irctc


Avoid - Teleco, Pharma, Banks, Insuranece? , Chem dependent on pharma, hospitals ?, Aviation?
Micro indexing.
Mapping with other growing economies.
Sector rotation.